%%%%%%%%%%%%%%%%%%%%
%             .....%
%   ..         ....%
%    ..          ..%
%    ...           %
%       G  G       %
%..                %
%....              %
%....          ....%
%........P    .....%
%%%%%%%%%%%%%%%%%%%%
